1111111111111111111
1C000100C00000001C1
1101011101111010001
10010000C1C10P1C111
101101010101E1111C1
10C1C1C1C1CC00000C1
1111111111111111111
